111111111111111
1E1000000C00001
1010000C0000001
100001111111111
101111000000001
100001111111101
10010P000C00001
111111111111111