11111111111111111111111111
1PCCCCCCCC00CCCCCCCCCCE111
100000000011000000000000C1
11111111111111111111111111