111111111111111111111
1PCCCCCC00000CCE11111
1000000000000C0000C11
111111111111111111111