111111111111111111111
1PCCCCCCCCCCCCCCCE111
1000000000000000000C1
111111111111111111111
