111111111111111
1CE00000C0000C1
111000C0000P001
111101011110111
1000000C0000001
1000C0000C000C1
100000000000001
111111111111111
111111111111111
111111111111111