111111111111
111111111111
111111111111
111111C11111
11111PCE1111
111111C11111
111111111111
111111111111