1111111111111
1001000000CN1
10N0011111001
1P0011E0C00N1
1111111111111