111111111111111
1E0C0000C00N0C1
10N000CN0N0P001
1C00011111100N1
10N0000C000N001
1000C00N0C000C1
10N00N0000N0001
111111111111111