111111111111111
1E0C0000C0000C1
10N000C0000P001
1N0001111110001
1000000C0000001
1000C0000C000C1
10000N000000001
111111111111111