111111111111111
1ENC0000C0000C1
1N0N00C0000P001
111111111111111
