111111111111111
1ECN0C00C0000C1
1N0CCNCN000P001
111111111111111
